NO   graph/NO.xpm
SO   graph/SO.xpm
WE   graph/WE.xpm
EA   graph/EA.xpm
S1   graph/S1.xpm
S2   graph/S2.xpm
S3   graph/S3.xpm
S4   graph/S4.xpm
S5   graph/S5.xpm
S6   graph/S6.xpm
DOOR graph/DOOR.xpm
S7   graph/S7.xpm

C     64,0,0
F     53,56,57

 111111111111111111111111111111
10000000000000000000000000000011
10002001111111111211111110000011
11000200000000000001110000010111
10001001212121212121212121212121
10011000000000000000000000011111
10001001111111222111111100001001
10010001000000000000000000001001
10010002000000000000000000002001
10001000000000000000001111112001
10000101111112111111111111111001
11111111111111111111111111110011
1000000001                 10001
1000000001                 10001
1000000001                 10001
1000000001                 10001
1000000001                 1001
1000000001111111111111111110001
100000000000000000W0000000000001
1111111111111111111111111111111
