NO   graph/NO.xpm
SO   graph/SO.xpm
WE   graph/WE.xpm
EA   graph/EA.xpm

C     223,162,144
F     255,244,230

 111111
10000001
10000001
1100N001
10001001
1001 101
10001001
10010001
10010001
10001001
10000101
 111111
