NO   graph/NO.xpm
SO   graph/SO.xpm
WE   graph/WE.xpm
EA   graph/EA.xpm

C     64,0,0
F     53,56,57

 111111
10000001
10N00001
 111111
