NO   graph/NO.xpm
SO   graph/SO.xpm
WE   graph/WE.xpm
EA   graph/EA.xpm
S1   graph/S1.xpm
S2   graph/S2.xpm
S3   graph/S3.xpm
S4   graph/S4.xpm
S5   graph/S5.xpm
S6   graph/S6.xpm
S7   graph/S7.xpm
DOOR graph/DOOR.xpm
C     64,0,0
F     53,56,57
 1111111111111
100000000000001
1000000000N0001
100000000000001
111211111111111
11121111111111
10000000000001
11111111111111
