NO   graph/NO.xpm
SO   graph/SO.xpm
WE   graph/WE.xpm
EA   graph/EA.xpm
S1   graph/S1.xpm
S2   graph/S2.xpm
S3   graph/S3.xpm
S4   graph/S4.xpm
S5   graph/S5.xpm
DOOR graph/DOOR.xpm

C     223,162,144
F     255,244,230

 1111111111111
100000001000001
100020020002001
1110N0000000001
111111111111111
