NO   graph/NO.xpm
SO   graph/SO.xpm
WE   graph/WE.xpm
EA   graph/EA.xpm

C     223,162,144
F     255,244,230

 111111111111111111
11000000000000N00001
10100000000000000001
10010000000000000001
10001000000000000001
10000100000000000001
 111111111111111111
10000000000000000111
 111111111111111111	
