NO   graph/NO_test.xpm
SO   graph/SO_test.xpm
WE   graph/WE_test.xpm
EA   graph/EA_test.xpm

C     64,0,0
F     85,85,85

 111111
10000001
10000E01
11000001
10001001
1001 101
10001001
10010001
10010001
10001001
10000101
 111111
