NO   graph/NO.xpm
SO   graph/SO.xpm
WE   graph/WE.xpm
EA   graph/EA.xpm

C     223,162,144
F     255,244,230

 111111
10000001
10000001
11000001
10100001
10010001
10001001
1N000101
 111111
