NO   graph/NO.xpm
SO   graph/SO.xpm
WE   graph/WE.xpm
EA   graph/EA.xpm

C     255,255,201
F     255,255,200

 111111111111111111
1W000000000000000001
 111111111111111111	
