NO   graph/NO.xpm
SO   graph/SO.xpm
WE   graph/WE.xpm
EA   graph/EA.xpm

C     255,255,201
F     255,255,200

 111111111111111111
10000000010000000001
10000000101000000001
10000000010000000111
10000000000000000111
100000000000000000E1
 111111111111111111 
10000000000000000111
 111111111111111111	
