NO   graph/NO.xpm
SO   graph/SO.xpm
WE   graph/WE.xpm
EA   graph/EA.xpm

C     223,162,144
F     255,244,230

 111111111111111111
100000000100000000E1
10000000101000000001
10000000010000000111
10000000000000000111
10000000000000000001
 111111111111111111
10000000000000000111
 111111111111111111	
