NO graph/NO.xpm
SO graph/SO.xpm
WE graph/WE.xpm
EA graph/EA.xpm

F 53,56,57
C 64,0,0

11111111111111111111
10000000W00000000001
11111111111111111101
10000000000000000101
10000000000000000101
10000000000000000101
10000000000000000101
10000000000000000101
11111111111111111111
